30000000000000000000000000000002
11111111111111111111111111111114
20000000000000000000000000000002
41111111111111111111111111111111
20000000000000000000000000000002
11111111111111111111111111111114
20000000000000000000000000000002
41111111111111111111111111111111
00000000000000000000000000000000
00000000000011100000000000000000
00000000000010110000000000000000
00000000000010010000000000000000
00000000000010010000000000000000
00000000000010011000000000000000
00000000000011001000000000000000
00000000000011001100000000000000
00000000001111000110000000000000
00000000001111100011110000000000
00000000011111110000011000000000
00000000010011110000001111111000
00000000010001111110000000001111
00000000011100000010000000000000
00000000010110000110000000000000
00000000010011111100000000000000
00000000011101100100000000000000
00000000010110000110000000000000
00000000010010000110000000000000
00000000011011111100111000000000
00000000001101000111101111100000
00000000000100000010000000111111
00000000000110000010000000000000
00000000000001111110000000000000
