00000000000000000000000000000000
00000000000001110000000000000000
00000000000010011000000000000000
00000000000011001000000000000000
00000000000001001000000000000000
00000000000001011000000000000000
00000000000001010011000000000000
00000000000011011110100000000000
00000000000010001100110000000000
11111111111110001111010000000000
00000000000000011100010000000000
00000000000000011100010000000000
00000000000000011111111000000000
00000000000000010110001000000000
00000000000000110000001000000000
00000000000000010000011000000000
00000000000000110001110000000000
11110000000000111111011000000000
00011111111000100000011000000000
00000000001100110000010000000000
00000000000110010000110000000000
00000000000010011111100000000000
00000000000011111000000000000000
00000000000000000000000000000000
00000000000000000000000000000000
00000000000000000000000000000020
11111111111111111111111111111114
02000000000000040000000000000020
41111111111111111111111111111111
02000000000000040000000000000020
11111111111111111111111111111114
30000000000000040000000000000020
